1111111111111
1C010000000C1
1100011111001
1P0011E000001
1000000001101
11000001100C1
1000100010011
11C1000011101
1C10001000001
1011101000001
1000000001011
10001010110C1
1111111001111
1C0000000C101
1111111111111