1111111111111
1C010000000C1
1100011111001
1P0001E000011
1111111111111