1111111111111
10P00000E0C01
1111111111111