1111111
1C00001
1000001
10000C1
10EP001
1000001
1111111