1111111111111
1C000000000C1
1000000000001
1P0000E000001
1000001100001
10000011000C1
1000011110001
10C0000000001
1C00000000001
1000000000001
1000000000001
10000000000C1
1000000000001
1C0000000C001
1111111111111