1111111111111
100P00E0C0001
1111111111111